C,  C,  C,  R,  C,  C,  C,
C,  R,  C,  C,  C,  R,  C,
C,  C,  R,  R,  C,  R,  C,
C,  R,  C,  C,  C,  R,  C,
C,  C,  R,  C,  C,  C,  C,