C,  R,  C,  R,  C,  C,  C,  R
C,  C,  C,  C,  R,  R,  R,  R
C,  C,  C,  R,  C,  C,  C,  R
C,  C,  B,  C,  C,  C,  C,  R
C,  C,  C-a-1,  C,  C,  C,  C,  R
C,  C,  R,  C,  C,  C,  M,  R
C,  C,  R,  C,  C,  C,  C,  C
